##########
#*#......#
#.#.#?#..#
#.#.#?#..#
#.^.#0..##
#.#.#....#
#####!##.#
#.%@#!##.#
#/%......#
##########